NO textures/simonkraft/respawn_anchor_side0.xpm
EA textures/simonkraft/respawn_anchor_side2.xpm
SO textures/simonkraft/respawn_anchor_side4.xpm
WE textures/simonkraft/respawn_anchor_side3.xpm

C 35,19,73
F 15,6,40

1111111111111111111111111111111111111111111111111111111
1111110001111111111111111111111111111111111111111111111
1111100000111111111111111111111111111111111111111111111
1111000N00011111111111111111111111111111111111111111111
1110000000001111111111111111111111111111111111111111111
1100000000000111111111111111111111111111111111111111111
1000011111000011111111111111111111111111111111111111111
1100001110000111111111111111111111111111111111111111111
1110000100001111111111111111111111111111111111111111111
1111000000011111111111111111111111111111111111111111111
1111100000111111111111111111111111111111111111111111111
1111110001111111111111111111111111111111111111111111111
1111111111111111111111111111111111111111111111111111111
