NO textures/test/north.xpm
SO textures/test/south.xpm
WE textures/test/west.xpm

EA textures/test/east.xpm

F 20,20,30
C 200,200,200


                              11111111
                        11111100000000111111
                    1111000000000000000000001111
                111100000000000000000000000000001111
              1100000000000000000000000000000000000011
            11000000000000000000000000000000000000000011
          110000000000000000000000000000000000000000000011
        1100000000000000000000000000000000000000000000000011
        1100000000000000000000000000000000000000000000000011
      11000000000000000000000000000000000000000000000000000011
      11000000000000000000000000000000000000000000000000000011
    110000000000000000000000000000000000000000000000000000000011
    110000000000000000000000000000000000000000000000000000000011
    110000000000000000000000000000000000000000000000000000000011
  1100000000000000000000000000000000000000000000000000000000000011
1111000000000000000000000000000N00000000000000000000000000000000011
111100000000000000000000000000000000000000000000000000000000000011
111100000000000000000000000000000000000000000000000000000000000011
    110000000000000000000000000000000000000000000000000000000011
    110000000000000000000000000000000000000000000000000000000011
    110000000000000000000000000000000000000000000000000000000011
      11000000000000000000000000000000000000000000000000000011
      11000000000000000000000000000000000000000000000000000011
        1100000000000000000000000000000000000000000000000011
        1100000000000000000000000000000000000000000000000011
          110000000000000000000000000000000000000000000011
            11000000000000000000000000000000000000000011
              1100000000000000000000000000000000000011
                111100000000000000000000000000001111
                    1111000000000000000000001111
                        11111100000000111111
                              11111111
